GGRRRRGG
GGRRRRGG
GGRRRRGG
GRRRRRRG
GRRRRRRG
GGRRRRRG
GGRRRRRG
GGGRRRRG
GGGRRRRG
GGGRRRRG
GGGRRRRG
GGGRRRRG
GGRRRRGG
GGRRRRGG
GGRRRRGG
GGRRRRGG
GGRRRRGG
GRRRRGGG
GRRRRGGG
GRRRRGGG
GRRRRGGG
GRRRRGGG
GRRRRGGG
GRRRRGGG
GRRRRGGG
GRRRRRGG
GRRRRRGG
GRRRRRGG
GRRRRRGG
GRRRRRGG
GRRRRRGG
GRRRRRRG
GRRRRRRG
GRRRRRRG
GGRRRRGG
GGRRRRGG
GGRRRRGG
GGRRRRGG
GRRRRRRG
GRRRRRRG
GRRRRRRG
GRRRRRRG
GRRRRRRG
GRRRRRRG
GGRRRRGG
GGRRRRGG
GGRRRRGG
GGRRRRGG
GRRRRRRG
GRRRRRRG
GRRRRRRG
GRRRRRRG
GRRRRRRG
GRRRRRRG
GGRRRRGG
GGRRRRGG
GGRRRRGG
GGRRRRGG
GRRRRRRG
GRRRRRRG
GRRRRRRG
GRRRRRRG
GRRRRRRG
GRRRRRRG
GGRRRRGG
GGRRRRGG
GGRRRRGG
GGRRRRGG
GRRRRRRG
GRRRRRRG
GRRRRRRG
GRRRRRRG
GRRRRRRG
GRRRRRRG
GGRRRRGG
GGRRRRGG
GGRRRRGG
GGRRRRGG
GRRRRRRG
GRRRRRRG
GRRRRRRG
GRRRRRRG
GRRRRRRG
GRRRRRRG
GGRRRRGG
GGRRRRGG
GGRRRRGG
GGRRRRGG
GRRRRRRG
GRRGGRRG
GRRGGRRG
GRRGGRRG
GRRGGRRG
GRRGGRRG
GRRGGRRG
GRRGGRRG
GRRRRRRG
GRRRRRRG
GRRRRRRG
GRRRRRRG
GRRRRRRG
GGRRRRGG
GGRRRRGG
GGRRRRGG
GGRRRRGG
GRRRRRRG
GRRRRRRG
GRRRRRRG
GRRRRRRG
GRRRRRRG
GRRRRRRG
GGRRRRGG
GGRRRRGG
GGRRRRGG
GGRRRRGG
GRRRRRRG
GRRRRRRG
GRRRRRRG
GRRRRRRG
GRRRRRRG
GRRRRRRG
GGRRRRGG
GGRRRRGG
GGRRRRGG
GGRRRRGG
GRRRRRRG
GRRRRRRG
GRRRRRRG
GRRRRRRG
GRRRRRRG
GRRRRRRG
GGRRRRGG
GGRRRRGG
GGRRRRGG
GGRRRRGG