G0G0R0R0R0R0G0G0
G0G0R0R0R0R0G0G0
G0G0R0R0R0R0G0G0
G0R0R0R0R0R0R0G0
G0R0R0R0R0R0R0G0
G0G0R2R0R0R0R0G0
G0G0R0R0R0R0R2G0
G0G0G0R0R0R0R0G0
G0G0G0R0R0R0R0G0
G0G0G0R0R0R0R0G0
G0G0G0R0R0R0R0G0
G0G0G0R0R0R0R1G0
G0G0R0R0R0R0G0G0
G0G0R0R0R3R0G0G0
G0G0R0R0R0R0G0G0
G0G0R0R0R0R0G0G0
G0G0R0R1R0R0G0G0
G0R0R0R1R0G0G0G0
G0R0R0R0R0G0G0G0
G0R0R0R0R0G0G0G0
G0R4R0R0R0G0G0G0
G0R0R0R0R0G0G0G0
G0R0R0R4R0G0G0G0
G0R2R0R0R0G0G0G0
G0R0R0R0R0G0G0G0
G0R0R0R0R1R0G0G0
G0R0R0R0R1R0G0G0
G0R0R0R0R0R0G0G0
G0R0R0R0R0R0G0G0
G0R0R1R0R0R0G0G0
G0R0R0R1R0R0G0G0
G0R0R0R0R0R0R0G0
G0R0R0R0R0R0R0G0
G0R0R0R4R0R0R0G0
G0G0R0R0R0R0G0G0
G0G0R0R0R0R0G0G0
G0G0R0R1R0R0G0G0
G0G0R0R0R0R0G0G0
G0R1R0R0R0R0R0G0
G0R0R0R0R0R0R0G0
G0R3R0R0R0R0R0G0
G0R0R0R0R0R0R1G0
G0R0R0R0R0R5R0G0
G0R2R1R0R0R0R0G0
G0G0R0R0R0R3G0G0
G0G0R0R0R0R0G0G0
G0G0R2R4R0R0G0G0
G0G0R0R0R2R0G0G0
G0R0R0R0R0R0R0G0
G0R0R2R0R0R0R0G0
G0R0R0R0R0R0R0G0
G0R0R0R0R1R0R0G0
G0R0R0R0R0R0R0G0
G0R0R0R5R4R0R0G0
G0G0R0R1R0R0G0G0
G0G0R0R0R0R0G0G0
G0G0R0R3R0R0G0G0
G0G0R0R0R0R1G0G0
G0R0R0R0R0R0R0G0
G0R0R0R0R0R0R1G0
G0R0R0R0R0R0R0G0
G0R0R0R0R0R0R0G0
G0R0R0R0R0R0R0G0
G0R0R0R0R0R0R0G0
G0G0R0R0R0R0G0G0
G0G0R0R0R0R0G0G0
G0G0R0R1R0R3G0G0
G0G0R0R0R0R0G0G0
G0R0R1R0R0R0R0G0
G0R0R0R0R0R0R0G0
G0R0R0R0R0R0R0G0
G0R0R0R2R0R0R0G0
G0R3R0R1R0R2R0G0
G0R2R0R0R0R0R0G0
G0G0R0R0R0R0G0G0
G0G0R0R0R0R1G0G0
G0G0R0R0R0R0G0G0
G0G0R0R0R0R0G0G0
G0R0R0R0R0R0R0G0
G0R0R0R0R0R1R0G0
G0R0R0R0R0R0R0G0
G0R0R0R0R0R0R0G0
G0R0R0R0R0R0R0G0
G0R0R0R0R0R0R0G0
G0G0R0R0R0R0G0G0
G0G0R0R0R0R0G0G0
G0G0R0R0R0R0G0G0
G0G0R0R0R0R0G0G0
G0R0R0R0R2R0R0G0
G0R0R0G0G0R0R0G0
G0R0R3G0G0R0R1G0
G0R0R0G0G0R0R0G0
G0R0R0G0G0R0R0G0
G0R0R0G0G0R0R0G0
G0R0R0G0G0R0R0G0
G0R0R0G0G0R0R0G0
G0R0R0R0R0R0R0G0
G0R0R0R0R0R0R1G0
G0R0R0R0R0R0R0G0
G0R0R0R0R1R0R0G0
G0R0R0R0R0R0R0G0
G0G0R0R0R0R0G0G0
G0G0R0R0R0R0G0G0
G0G0R0R0R0R0G0G0
G0G0R0R0R0R0G0G0
G0R0R0R0R0R0R0G0
G0R0R0R0R0R5R0G0
G0R0R0R0R0R1R0G0
G0R0R0R0R0R0R0G0
G0R0R0R0R0R0R0G0
G0R0R2R0R0R0R0G0
G0G0R2R0R0R0G0G0
G0G0R0R0R0R0G0G0
G0G0R0R0R0R3G0G0
G0G0R0R0R0R0G0G0
G0R0R0R0R0R0R2G0
G0R0R0R0R0R0R2G0
G0R0R0R0R0R0R0G0
G0R0R0R0R0R0R0G0
G0R0R0R0R0R0R0G0
G0R0R0R0R0R0R0G0
G0G0R0R1R0R0G0G0
G0G0R0R0R0R0G0G0
G0G0R0R0R0R0G0G0
G0G0R0R0R0R0G0G0
G0R0R0R0R0R0R0G0
G0R0R0R0R0R0R0G0
G0R0R0R0R0R3R0G0
G0R0R0R0R0R0R0G0
G0R0R0R2R0R0R0G0
G0R0R0R0R0R0R0G0
G0G0R0R0R1R0G0G0
G0G0R0R0R0R0G0G0
G0G0R0R0R0R0G0G0
G0G0R3R0R0R0G0G0
G0R0R0R0R0R0R0G0
G0R3R0R0R0R0R1G0
G0R0R0R0R0R0R0G0
G0R0R0R0R0R0R0G0
G0R0R0R0R1R0R0G0
G0R0R1R0R0R0R1G0
G0G0R0R0R0R0G0G0
G0G0R0R0R0R0G0G0
G0G0R0R0R1R0G0G0
G0G0R0R0R0R0G0G0
G0R0R0R0R2R0R0G0
G0R1R5R0R0R0R0G0
G0R0R0R1R0R0R0G0
G0R0R0R0R0R0R0G0
G0R0R0R0R1R0R0G0
G0R0R0R0R2R0R0G0